0001010100000
1E010S0101111
0001000101000
1111011101111
0000010000000
1111010111111
0001010100000