0000000010
0S11111010
00000010E0
0011101000
1F10101111
0000100000
11111011F1
0000001000
1111111011
0000000010