0001010000000
0S11010111100
0000010F00100
0111110110110
0100000010010
0111011110110
0001010000100
111↕1↕11E0111
0001010000000