0010000000000
0010111000000
0011101000000
000000101F110
1100111010011
0110100010000
001110S010E10
0000001010010
0011111011110
0010000000000