0000000000000
0000000T00000
000T000100000
00010011T1E00
0T11001000000
0001001000000
000111S111000
0000001001000
00000010011T0
00T1111001000
000010000T000
0000T00000000
0000000000000