0000000000000
0000000111T00
0001111100000
000100011T000
0S1↔110000000
00010111111T0
0001100001000
0000111101110
0000001000000
0000001111E00
0000000000000