000000000000
0T11111111T0
000100010100
0001110S0100
0T0001010100
010001111100
011100010000
0001000T0E00
011100000100
010001111100
011111000000
000000000000