000000000000
0T000S000T10
010T1↕1T0010
010001000010
011T0T0T0110
000000010100
110001110111
011111000000
000000000000
0T1101111000
0001110011E0
000000000000