0000100010000
0S11111111110
000c0c0c0c010
000ccc0ccc010
0000000000010
0E1111c111110
0000000000000
0000ccccc0000
0000100010000