0000000000000
0E011111111S0
01c1000000010
0100000000010
0100000000010
0110000000010
00c0000001c10
0E111111110E0
0000000000000