0100000000000
0S00111111E00
0100100000000
1100101111c11
010010c000c00
1100101111c11
0100101000c00
1100111111c11
0100000000000