S00000000000c
0000000000000
001111E011100
0010000010100
0010111010T00
0010101010000
0011101110000
0000000000000
T00000000000c