0000000000000
000c11111c000
0001001001000
0001001001000
011↕11E11↕110
0101001001010
0101001001010
011c11111c110
000000S000000
0000000000000