00000000000
00001110000
00001↕10000
0001↕c↔1000
001↔1↔1↕100
0E↔1↕1↔1↔S0
001↕1↔1↕100
0001↔c↕1000
00001↕10000
00001110000
00000000000