0000000000000
0111000001110
01E1000001c10
011↕10001↔110
0001↔111↕1000
0000111110000
000011S110000
0000111110000
0001↕111↔1000
011↔10001↕110
01c1000001c10
0111000001110
0000000000000