0S0000000100
E↕1011110100
01↔110011100
00100c100000
101001↕11111
101000110000
11↔110011110
0011↕c000010
00c111000110
000000000100