000000000
0S0011100
010010110
011010010
001110E10
000000000