0000000000
0S11011100
0001110100
0E00000110
0110111010
0011101110
0000000000