000010000
000010000
0S1110000
000000000
0000111E0
000010000
000010000