000000000
0E1111110
000000010
0S1000010
001011110
001010000
111011111
000000000