000000000
0S1110000
000010000
111011111
001000000
1110E1111
000000000