000000000
0T11110S0
000001010
000001010
0E11110T0
000000000