000000000
0S1111T00
000000000
111110T11
000010000
000011E00
000000000