000000000
0S11101T0
000010100
00T0T0110
001000010
001011110
001010000
1110E1111
000000000