0000000000
0Sccc011E0
00c1c01000
00ccc0ccc0
001000c1c0
001111ccc0
0000000000