000000000
010101010
001010100
010101010
000000000
0S11F11E0
000000000