00000000000
00S0E111100
00100000100
0010F110110
01101010010
01001111110
01101000000
00101000000
00111000000
00000000000