0100000000000
01111100000S0
0000010111010
01F1011101110
0101000000000
01110111011E0
0101110111000
0100000000000