000000000
011111110
010100010
011↕1E0S0
010100010
011111110
000000000