000000000
0S1↔11110
000100010
000111010
000101010
0E1↕11010
000100010
011↔11110
010100000
011100000
000000000