000010000010
011110001110
010000001000
0110E0S1↔110
001010001010
1110100011↕1
000010000010