0000000000000
00000ccccccc0
00000c00000c0
00E00ccccccc0
0010011111110
0111010100010
11T1110S0T1↕1
0111010100010
0010011111110
00E00ccccccc0
00000c00000c0
00000ccccccc0
0000000000000