0000000000000
0c111101111c0
0111110┼↕↔110
011S1c0c11000
01111↕1↔↕↕110
0111↕1↔111110
0111101011110
01↕0001001↔10
0┼1001↕100┼┼0
0c00Ec1cE00c0
0000000000000